アリサ=Arisa
イリヤ・オーンスタイン=Illya Ornstein
ヴァンピィ=
クリスティーナ・モーガン=Christina Morgan
クレア・ボヤンシア=
ジータ=Djeeta
ニノン・ジュベール=Ninon Joubert
ビカラ=
モニカ・ヴァイスヴィント=Monika Weisswind
ユースティアナ・フォン・アストライア=Eustiana von Astraea
リマ=Lima
ルナ=Luna
一ノ瀬 祈梨=
三角 千歌=Chika Misumi
上喜 しのぶ=Shinobu Kamiki
丹野 七々香=Nanaka Tanno
佐々木 咲恋=Saren Sasaki
倉石 恵理子=Eriko Kuraishi
出雲 宮子=Miyako Izumo
北条 綾音=Ayane
千里 真那=
卯ノ花 蘭=
双葉 碧=Aoi Futaba
喜屋武 香織=Kaori Kyan
園上 矛依未=Muimi Sonoue
士条 怜=Rei Shijo
大神 美冬=Mifuyu Ogami
天野 すずめ=Suzume Amano
太刀洗 流夏=Ruka Tachiarai
姫宮 真歩=Maho Himemiya
安芸 真琴=Makoto Aki
宮坂 たまき=Tamaki Miyasaka
宵ヶ浜 深月=Mitsuki Yoigahama
島村 卯月=Uzuki Shimamura
御久間 智=Tomo Mikuma
徳川 莉々=
志木場 寝亜=
愛川 美里=Misato Aikawa
支倉 伊緒=Io Hasekura
星野 静流=Shizuru Hoshino
春咲 ひより=Hiyori Harusaki
本田 未央=Mio Honda
柊 杏奈=Anna Hiragi
柏崎 初音=Hatsune Kashiwazaki
柏崎 初音＆柏崎 栞=
柏崎 栞=Shiori Kashiwazaki
栗林 くるみ=Kurumi Kuribayashi
桜井 望=Nozomi Sakurai
棗 こころ=Kokoro Natsume
森近 鈴=Rin Morichika
模索路 晶=
氷川 鏡華=Kyoka Hikawa
流 魅空=
渋谷 凛=Rin Shibuya
玉泉 美咲=Misaki Tamaizumi
現士実 似々花=Neneka Utsushimi
白銀 純=Jun Shirogane
百地 希留耶=Kiruya Momochi
真行寺 由仁=Yuni Shingyoji
石橋 あゆみ=Ayumi Ishibashi
穂高 みそぎ=Misogi Hodaka
穂高 みそぎ＆茜 ミミ＆氷川 鏡華=
綾瀬 ゆかり=Yukari Ayase
織原 茉莉=Matsuri Orihara
繭宮 つむぎ=Tsumugi Mayumiya
美波 鈴奈=Suzuna Minami
茜 ミミ=Mimi Akane
草野 優衣=Yui Kusano
藤堂 秋乃=Akino Todo
藤堂 秋乃＆佐々木 咲恋=
虹村 雪=Yuki Nijimura
衣之咲 璃乃=Rino Inosaki
観崎 佳凛=
遠見 空花=Kuka Tomi
遠野 帆稀=
野戸 まひる=Mahiru Noto
阿賀斗 紫布菜=
霧原 かすみ=Kasumi Kirihara
風宮 あかり=Akari Kazemiya
風宮 より=Yori Kazemiya
風間 ちえる=Chieru Kazama
鬼道 嘉夜=Kaya Kido
黒江 花子=Hanako Kuroe

