ＨＰ回復量減少=
ＨＰ変化=HP Change
スタン=Stun
スタン（別枠）=
スロウ=Slow
スロウ(加算可能)=
スロウフィールド=
トナカイ化=Reindeerification
ノックバック=Knock(ed) back
バフ消去=
バフ消去（指定）=
バリア消去=
ヘイスト=Haste
ヘイスト(加算可能)=
ヘイストフィールド=
凍結=Freeze
刻印付与=(Gain) Crest
千里眼=Clairvoyance
即死=Death
呪い=Curse
呪い（別枠）=
呪詛=Scourge
回復阻害=Chronic
弱体被ダメージ上昇=
恐慌=Panic
拘留=Confine
拘留(ダメージ)=Confine (Damage)
時間停止=
暗闇=Blind
束縛=Bind
殴り刻印（攻撃ヒット）=
毒=Poison
毒（別枠）=
気絶=Daze
沈黙=Silence
混乱=Confusion
混乱（別枠）=
火傷=Burn
猛毒=Venom
畏怖=Cower
睡眠=Sleep
石化=Petrify
結晶化=
行動時毒ダメージ=
魅了=Charm
麻痺=Paralyze
黒炎=

