？？？=???
ヴァイスフリューゲル　ランドソル支部=Weissflügel (Landosol Branch)
カルミナ=Carmina
きのこと小川=Mushroom Creek
きのこと秋の渓谷=Autumn Scenery - Mushroom Valley
クリスマスの夜=Festive (Evening)
クリスマスの昼=Festive (Afternoon)
サマービーチの夕日=Summer Beach (Sunset)
サマービーチの星空=Summer Beach (Starry Sky)
サマービーチの朝日=Summer Beach (Sunrise)
サレンディア救護院=Sarendia Orphanage
トゥインクルウィッシュ=Twinkle Wish
ドラゴンズネスト=Dragons' Nest
トワイライトキャラバン=Twilight Caravan
ニュージェネレーションズ=New Generations
ハロウィンの夜=Halloween (Evening)
ハロウィンの昼=Halloween (Afternoon)
フォレスティエ=Forestier
メルクリウス財団=Mercurius Foundation
ラビリンス=Labyrinth
リトルリリカル=Little Lyrical
ルーセント学院=Lucent Academy
不思議の国のお城=
不思議の国の平原=
初日の出=First Sunrise
天の川=
悪魔偽王国軍\n（ディアボロス）=Diabolos
海中の背景=Underwater Scenery
牧場\n（エリザベスパーク）=Elizabeth Park
王宮騎士団\n（NIGHTMARE）=Nightmare,\nDefenders of the Throne
美食殿=Gourmet Guild
聖テレサ女学院\n（なかよし部）=St. Theresa's Academy\n(Friendship Club)
自警団（カォン）=Caon
願い竹の村の夜=
願い竹の村の昼=

