「チーズお守り大作戦！」追加公演ポスター=
『ナッシュカッツェ』の招き猫=
１stアニバーサリーウォール=1st Anniversary Wall
１stアニバーサリーオルゴール=1st Anniversary Music Box
１stアニバーサリーサイドテーブル=1st Anniversary Side Table
１stアニバーサリーテーブル=1st Anniversary Table
１stアニバーサリーフラワーポール=1st Anniversary Flower Pole
１stアニバーサリーフロア=1st Anniversary Flooring
１stアニバーサリーモニュメント=1st Anniversary Monument
２ndアニバーサリーバルーンスタンド=2nd Anniversary Balloon Stand
２ndアニバーサリーバルーンブランコ=2nd Anniversary Balloon Swing
２ndアニバーサリー美食殿バルーンスタンド=2nd Anniversary Balloon Stand (Gourmet Guild)
３rdアニバーサリーフォトブック=
あったかだるまストーブ=Potbelly Stove
アースサボテンのハニーパンケーキ=
アイちゃんクッション=Ai the Eyeball Cushion
アイドリッシュダンスフロア=Idol Dance Floor
アニメ【美食殿】ギルドハウス壁面=
アニメ【美食殿】ギルドハウス床面=
アラベスク模様のパーテーション=Arabesque Partition
アロマディフューザー①=Aroma Diffuser 1
アロマディフューザー②=Aroma Diffuser 2
ウッディウォール=Woodland Wall
ウッディオットマン=Woodland Ottoman
ウッディサイドテーブル=Woodland Side Table
ウッディシェルフ=Woodland Shelf
ウッディスツール=Woodland Stool
ウッディソファ=Woodland Armchair
ウッディソファベンチ=Woodland Sofa Bench
ウッディダイニングテーブル=Woodland Dining Table
ウッディチェア=Woodland Chair
ウッディパーテーション=Woodland Partition
ウッディフェンス=Woodland Fence
ウッディフロア=Woodland Flooring
ウッディベッド=Woodland Bed
ウッディローテーブル=Woodland Coffee Table
エクスタシージャンパートロフィー=Ecstasy Leaper Trophy
エレガントなタペストリー=Elegant Banner
おすわり狼犬のだいしゅきぐるみ=
おやつテーブル=Snack Table
お絵かきキッズテーブル=Artsy Kids' Table
オーエド湯煙シェード=
オーシャンスツール=Ocean Stool
オーシャンパーテーション=Ocean Partition
オーマ地域振興ポスター『新春トゥンヌス釣上図柄』=
オーロラの明かり窓=Aurora-View Window
オシャレなウォールランプ=Stylish Wall Lamp
がうがう狼犬のだいしゅきぐるみ=
カォンの武器樽=Caon Weapon Barrel
カフェウッドカウンターテーブル=Wooden Cafe Counter
カフェウッドチェア=Wooden Cafe Chair
カフェウッドテーブル&チェアセット=Wooden Cafe Table & Chair
カフェウッドパーテーション=Wooden Cafe Partition
カフェボード=Cafe Menu Board
カフェメニューイラストの背景=Cafe Menu Art Background
カフェランプ=Cafe Lamp
カフェレジスター=Cafe Register
カボチャのオーナメント=Decorative Pumpkin
カボチャのカップボード=Pumpkin Cupboard
カボチャのキャンドルスタンド=Pumpkin Candleholder
カボチャのソファ=Pumpkin Armchair
カボチャのチェスト=Pumpkin Chest
カボチャのパーテーション=Pumpkin Partition
カラータイル①=Color Tile 1
カラータイル②=Color Tile 2
カラータイル③=Color Tile 3
カラータイル④=Color Tile 4
カラータイル⑤=Color Tile 5
カラータイル⑥=Color Tile 6
カラータイル⑦=Color Tile 7
カラータイル⑧=Color Tile 8
カリンの机=Karin's Table
カルミナメモリアルコレクションシェルフ=
きらめく星のクリスマスツリー=Star-Topped Holiday Tree
キッズアートウォール=Kids' Decorative Wallpaper
キッズアートフロア=Kids' Decorative Flooring
キャッと飛び出るワンダーボックス=Box of Surprises
キョウカの黒猫ほうき=Kyoka's Black Cat Broom
ギルドハウスの壁=Guildhouse Wall
ぐるぐるうさぎさん=Mummy Bunny
グリーンジェリーフィッシュライト=Green Jellyfish Lamp
クリスティーナ・リゾートスパ=Christina's Resort Spa
クリスマスツリーブックシェルフ=Holiday Tree Bookshelf
クリスマスの背景=Festive Background
クリスマスラグの床=Festive Rug Flooring
クリスマス暖炉=Festive Fireplace
ゴールデンセンリ像=
ゴールデンハウスの壁=
ゴールデンハウスの床=
ゴールデン無限おにぎり=
ゴシックウォールカーテン=Gothic Wall Curtains
ゴシックキャンドル=Gothic Candlestick
ゴシックシェード=Gothic Shade
ゴシックソファ=Gothic Couch
ゴシックドレッサー=Gothic Dressing Table
ゴシックナイトフロア=Gothic Flooring
ゴシックベッド=Gothic Bed
コッコロのおさいふ=
サイフォン付きカフェキッチンボード=Cafe Coffeemaker Cupboard
サンゴの置物=Coral Ornament
ジュンのスペア鎧=Jun's Spare Armor
シンフォニックスターステージ サイドユニット=Symphonic Star Stage (Side Unit)
シンフォニックスターステージ メインユニット=Symphonic Star Stage (Main Unit)
スウィーツショーケース=Dessert Showcase
スウィートバレンタイントロフィー=Sweet Valentine's Trophy
ステージセットのドレープ壁=Stage Curtain Wall
ステンドグラスのパーテーション=Stained Glass Partition
スノーマンベア=Snowbear
スペシャルハロウィンスタンド=Special Halloween Stand
チョコレートファウンテン=Chocolate Fountain
どこでもシチュー鍋=Handy Stew Pot
どこでも紅葉盆栽=Autumn Bonsai
どこでも茶屋=Portable Tearoom
トカゲ？のぬいぐるみ=
トップアイドルのトルソー=Top Idol Costume
トナカイチェア=Reindeer Chair
なかよしＸ　Ｍｋ―Ⅱ=Friendbot X Mk. II
なりきりおにぎり=Rice Ball Costume
ねこのぬいぐるみ=Plush Cat Doll
ネイティブ柄のカラフル床=Patterned Rug Flooring
ネビアのくつろぎツリーハウス=Nebbia's Comfy Treehouse
ネビアのやすらぎビオトープ=Nebbia's Leisurely Biotope
パーテーションポール=Rope Partition
ハッピーハロウィンバスケット=Happy Halloween Basket
バルーンバードデザインラグ=Balloon Bird Rug
ハロウィンウォール=Halloween Wall
ハロウィンサークルテーブル=Round Halloween Table
ハロウィンスツール=Halloween Stool
ハロウィンダイニングテーブル=Halloween Dining Table
ハロウィンチェア=Halloween Chair
ハロウィントリックボックス=Halloween Trick Box
ハロウィンフロア=Halloween Flooring
ハロウィンベッド=Halloween Bed
ハロウィンワールド=Halloween World
ピップルのおうち=
ピンクシェルクッション=Pink Shell Cushion
ピンクのスツール=Pink Stool
ピンクのソファ一人用=Pink Couch
ピンクのソファ二人用=Pink Loveseat
ピンクのチェスト=Pink Chest
ピンクのドレスのトルソー=Pink Dress
ピンクのネイティブ柄クッション=Pink Patterned Cushion
ピンクのパーテーション=Pink Partition
ピンクのベッド=Pink Bed
ピンクのモノグラムの背景①=Pink Monogram Background 1
ピンクのモノグラムの背景②=Pink Monogram Background 2
ピンクのラグ=Pink Rug
ピンクの壁=Pink Wall
ピンクの床=Pink Flooring
ピンクの机①=Pink Desk 1
ピンクの机②=Pink Desk 2
ピンクの椅子=Pink Chair
ふかふかシードレイク=Flufftastic Sea Drake
ふわふわスポンジスツール（オレンジ）=Spongy Stool (Orange)
ふわふわスポンジスツール（バイオレット）=Spongy Stool (Violet)
ふわふわスポンジスツール（ピンク）=Spongy Stool (Pink)
ファンシーウォールカーテン=Fancy Wall Curtains
ファンシーシェード=Fancy Shade
ファンシーソファ=Fancy Sofa
ファンシーチェックフロア=Fancy Checkered Flooring
ファンシードレッサー=Fancy Dressing Table
ファンシーな上階段=Fancy Upward Stairwell
ファンシーな下階段=Fancy Downward Stairwell
ファンシーな柱=Fancy Pillar
ファンシーベッド=Fancy Bed
ファンシーローゼス=Fancy Roses
プチコのツリーネスト=
ブッシュ・ド・ノエルの甘いスツール=Yule Log Stool
プリぐるみ（カオリ）=PriPlushie (Kaori)
プリぐるみ（カスミ）=PriPlushie (Kasumi)
プリぐるみ（キャル）=PriPlushie (Karyl)
プリぐるみ（コッコロ）=PriPlushie (Kokkoro)
プリぐるみ（シェフィ）=
プリぐるみ（ペコリーヌ）=PriPlushie (Pecorine)
プリぐるみ（マコト）=PriPlushie (Makoto)
プリぐるみ（マホ）=PriPlushie (Maho)
プリぐるみスペシャル（アメス）=
プリンセスシアター=
ブルージェリーフィッシュライト=Blue Jellyfish Lamp
ブルーシェルクッション=Blue Shell Cushion
ぺコリーヌの手作りウッドテーブル=
ぺコリーヌの手作りログスツール①=
ぺコリーヌの手作りログスツール②=
ペールトーンの壁=Pale-Tone Wall
ポーション生成機=Potion Creation Device
ホームメイドグリーンラグ=Homemade Green Rug
ホームメイドパターンドラグ=Homemade Patterned Rug
ポップなカフェボード=Fancy Cafe Menu Board
ボトルラック=Bottle Rack
ホワイトロッキングチェア=White Rocking Chair
マコトの秘密の宝箱=Makoto's Treasure Chest
マジカルシャイニーレイピア=
マジカルピュアリーボウ=Magical Purely Bow
マジカルミスティロッド=Magical Misty Wand
マジカルラブリーソード=
マスター・センリの信楽焼=Master Senri Ornament
マダムピックのモフモフぬいぐるみ=Giant Peakie Hen Plushie
マツリのスペア盾=Matsuri's Spare Shield
マナ生成機=Mana Creation Device
マホガニーのスツール=Mahogany Stool
マホガニーのチェスト=Mahogany Chest
マホガニーのパーテーション=Mahogany Partition
マホガニーのベッド=Mahogany Bed
マホガニーの上階段=Mahogany Upward Stairwell
マホガニーの下階段=Mahogany Downward Stairwell
マホガニーの壁=Mahogany Wall
マホガニーの床=Mahogany Flooring
マホガニーの机①=Mahogany Desk 1
マホガニーの机②=Mahogany Desk 2
マホガニーの椅子=Mahogany Chair
マホマホ王国の壁=Maho-Maho Kingdom Wall
マホ愛蔵のぬいぐるみ=Maho's Plushie Set
みんなのカレンダー=
みんなのゲームテーブル=Amazing Game Table
みんなのトイフレンドくん=
ミステリークリスタルセット=Mystical Crystal Ball
ミニベアのサイドテーブル=Teddybear Side Table
メイド服のトルソー=Maid Costume
メモリアルサウンドボックス=Memorial Jukebox
メモリアルマップボード=Memorial Map Board
メルヘンドレスカーテン=Fairy-tale Curtain
メルヘンランプ=Fairy-tale Lamp
モザイクタイルの床=Mosaic Tile Flooring
モノクロタイルの床=Monochrome Tile Flooring
ゆらゆら楽しい木馬のプチグリフォン=Mini-Gryphon Rocking Horse
ライオンの噴水=Lion Fountain
ラグマットフロア=Winter Rug Flooring
ラジオブースチェア（グリーン）=
ラジオブースチェア（パープル）=
ラジオブーステーブル=
ランドソルの背景=Landosol Background
リゾートプランツ=Resort Plant
リゾート気分のクローゼット=Resort Wardrobe
リゾート気分のスツール=Resort Stool
リゾート気分のソファ一人用=Resort Armchair
リゾート気分のソファ二人用=Resort Loveseat
リゾート気分のチェア=Resort Chair
リゾート気分のチェスト=Resort Chest
リゾート気分のハンモック=Resort Hammock
リゾート気分のビーチチェア=Resort Beach Chair
リゾート気分の壁=Resort Wall
リゾート気分の床=Resort Flooring
リゾート気分の机①=Resort Table 1
リゾート気分の机②=Resort Table 2
リゾート気分の食器棚=Resort Cupboard
リマサンタのフワモコ着ぐるみ=Lima Santa Costume
リマのぬいぐるみ=Lima Costume
レディ・ザ・バニー=Madame Bunny
レディベア=Madame Bear
ワフト=
上ウッドラダー=Upward Wooden Ladder
下ウッドラダー=Downward Wooden Ladder
二色角のトナカイぬいぐるみ=Odd-Antler Reindeer Plushie
人気アイドルグループのタペストリー=Idol Group Wall Pennant
人気アイドルグループのバナーフラッグ=Idol Group Hanging Banner
修練用の大砲=Training Cannon
修練用の木人=Training Dummy
冬景色の背景=Wintry Background
剣の壁掛け=Wall-mounted Sword
十五夜セット=Moon Viewing Set
夜色のカウチソファ=Night Sky Couch Segment
夜色のコーナーカウチ=Night Sky Couch Corner
夜色のニットクッション=Night Sky Cushion
夢を運ぶそり=Magical Sleigh
大理石の壁=Marble Wall
大理石の床=Marble Flooring
天露の金甘水=
学校の上階段=School Upward Stairwell
学校の下階段=School Downward Stairwell
密林の果実=Deepwood Fruit
市松模様の畳=Checkered Tatami
床の間の壁=Open-Air Wall
床下アクアリウム=Floor Aquarium
怪鳥の雛ちゃん=
手すり①=Handrail 1
手すり②=Handrail 2
教室のロッカー=Classroom Locker
教室の壁=Classroom Wall
教室の壁掛け時計=Classroom Wall Clock
教室の床=Classroom Flooring
教室の掃除用具=Classroom Cleaning Supplies
教室の掲示板=Classroom Noticeboard
教室の本棚=Classroom Bookcase
教室の机=Classroom Desk
教室の黒板=Classroom Blackboard
断崖の点心=Sheercliff Dumplings
星空のティピーテント=Starry Tepee Tent
星空のふわふわロフトベッド=Starry Loft Bed
春色小紋=Springtime Kimono
暖炉①=Fireplace 1
暖炉②=Fireplace 2
月見ロップの襖=Autumn Rabbicorn Panel
月見紅葉の背景=Autumn Moon Background
木のスツール=Wooden Stool
木のチェスト=Wooden Chest
木のパーテーション=Wooden Partition
木のベッド=Wooden Bed
木の上階段=Wooden Upward Stairwell
木の下階段=Wooden Downward Stairwell
木の壁=Wooden Wall
木の床=Wooden Flooring
木の机①=Wooden Desk 1
木の机②=Wooden Desk 2
木の椅子=Wooden Chair
本格仕様のオーブン=Professional Oven
本棚①=Bookshelf 1
本棚②=Bookshelf 2
桜の木=Cherry Blossom Tree
樽=Barrel
欅の座敷机=Elm Floor Table
正月飾りの鏡餅=New Year's Kagami Mochi
正月飾りの門松=New Year's Kadomatsu
正統派なカフェの壁=Traditional Cafe Wall
氷晶のガーランド=Icy Garland
海中の背景=Undersea Background
海底の壁=Seabed Wall
海底の床=Seabed Flooring
淑女の五箇条覚え書き=
深海直送の無限海鮮箱=
清涼の金魚鉢=Elegant Fishbowl
漆塗りの座敷椅子=Lacquer Stool
漆塗りの机=Lacquer Table
漆塗りの椅子=Lacquer Chair
灯籠型照明=Lantern Light
無限おにぎり=Infinite Rice Ball
煉瓦のパーテーション=Brick Partition
煉瓦の壁=Brick Wall
煉瓦の床=Brick Flooring
熱帯魚のステッカー=Tropical Fish Stickers
王宮調の上階段=Palace Upward Stairwell
王宮調の下階段=Palace Downward Stairwell
王宮調の壁=Palace Wall
王宮調の床=Palace Flooring
王宮騎士団×ランフェス求人ポスター=
王宮騎士団の鎧の置物=Nightmare Armor Figurine
畳床=Tatami Mats
白いドレスのトルソー=White Dress
白い石畳の床=White Stone Flooring
白のスツール=White Stool
白のソファ一人用=White Couch
白のソファ二人用=White Loveseat
白のチェスト=White Chest
白のパーテーション=White Partition
白のベッド=White Bed
白のラグ=White Rug
白の上階段=White Upward Stairwell
白の下階段=White Downward Stairwell
白の吊り戸棚=White Hanging Shelves
白の壁=White Wall
白の床=White Flooring
白の机①=White Desk 1
白の机②=White Desk 2
白の椅子=White Chair
白亜の水盤=Marble Basin
白銀色のベンチ=Pearly Bench
白銀色の柱=Pearly Pillar
盾の壁掛け=Wall-mounted Shield
石畳の壁=Stone Wall
石畳の床=Stone Flooring
石膏の彫像①=Plaster Statue 1
石膏の彫像②=Plaster Statue 2
神楽鈴=Ceremonial Bell
秋ゴーレムのししおどし=Autumn Golem Water Feature
秋月模様の襖=Autumn Moon Panel
精霊石のミニモノリス=
紅葉柄の布団=Autumn Leaves Futon
絵画①=Painting 1
絵画②=Painting 2
絶世の卵と山盛りご飯=Ultimate Egg on Fluffy Rice
緑毛のトナカイぬいぐるみ=Green-Fur Reindeer Plushie
置時計①=Clock 1
置時計②=Clock 2
置行燈=Indoor Lantern
老舗旅館の座椅子=Ryokan Floor Seat
聖夜に寄り添うダブルソファ=Festive Loveseat
聖夜に弾むシングルソファ=Festive Armchair
聖夜のスノードーム=Festive Snow Globe
聖夜のディナーテーブル①=Festive Dinner Table 1
聖夜のディナーテーブル②=Festive Dinner Table 2
聖夜の大きなプレゼント=Big Festive Present Stash
聖夜を彩る飾り壁=Festive Wall
聖夜を駆けるベッド=Sled Bed
腰付き障子=Traditional Panel
至高のドラゴンテイルおでん=Dragon Tail Hotpot
花①=Flower 1
花②=Flower 2
花の壁掛け=Flower Wreath
花柄のクローゼット=Flowery Wardrobe
花柄のスツール=Flowery Stool
花柄のソファ一人用=Flowery Seat
花柄のソファ二人用=Flowery Loveseat
花柄のダイニングテーブル=Flowery Dining Table
花柄のチェスト=Flowery Chest
花柄のパーテーション=Flowery Partition
花柄のベッド=Flowery Bed
花柄のローテーブル=Flowery Tea Table
花柄の壁=Flowery Wall
花柄の床=Flowery Flooring
花柄の椅子=Flowery Chair
花鳥風月の背景=Nature Motif Background
茶のソファ一人用=Brown Couch
茶のソファ二人用=Brown Loveseat
蒼き飛空艇の模型=
蒼海の淡雪飴=Tideborne Sweetsnow
蒼穹の背景=
薬棚=Medicine Cabinet
虎の敷物=Tiger Rug
襖絵の壁=Sliding Screen Wall
観葉植物①=Decorative Plant 1
観葉植物②=Decorative Plant 2
赤い敷物と木目の床=Red Rug Wooden Flooring
赤い絨毯の上階段=Red Carpeted Upward Stairwell
赤い絨毯の下階段=Red Carpeted Downward Stairwell
赤い絨毯の床=Red Carpet Flooring
赤のソファ一人用=Red Couch
赤のソファ二人用=Red Loveseat
赤のラグ=Red Rug
赤白タイルの床=Red and White Tile Flooring
輝く結晶のオブジェ=
透明壁=Transparent Wall
透明床=Transparent Flooring
金箔の屏風=Gold Leaf Screen
釣竿=Fishing Rod
階段和箪笥=Staircase Drawers
雪色のカウチソファ=Snowy Sky Couch Segment
雪色のコーナーカウチ=Snowy Sky Couch Corner
雪色のニットクッション=Snowy Sky Cushion
雪色の編み物椅子=Snowy Sky Knitting Chair
雲海の魔物肉=Cloudtop Monster Meat
青のモノグラムの背景①=Blue Monogram Background 1
青のモノグラムの背景②=Blue Monogram Background 2
飛び出す聖夜の物語=Festive Pop-up Book
食器棚=Cupboard
魔法の本立て=Magic Bookstand
黄色のモノグラムの背景①=Yellow Monogram Background 1
黄色のモノグラムの背景②=Yellow Monogram Background 2
黒のスツール=Black Stool
黒のソファ一人用=Black Couch
黒のソファ二人用=Black Loveseat
黒のチェスト=Black Chest
黒のパーテーション=Black Partition
黒のベッド=Black Bed
黒のラグ=Black Rug
黒の上階段=Black Upward Stairwell
黒の下階段=Black Downward Stairwell
黒の壁=Black Wall
黒の床=Black Flooring
黒の机①=Black Desk 1
黒の机②=Black Desk 2
黒の椅子=Black Chair

