アイスチック=Yuki's Shadow
アイスフィッシュ=Seahorse Knight
アイスモール=Miyako's Shadow
アオイのシャドウ=Aoi's Shadow
アカリのシャドウ=Akari's Shadow
アキノのシャドウ=Akino's Shadow
アヤネのシャドウ=Eriko's Shadow
アユミのシャドウ=Ayumi's Shadow
アルトバード=Alto Bird
アルトハーピィ=
アンナのシャドウ=Anna's Shadow
イオのシャドウ=Wisewand
イカリイカ=
イクト・ガラディオン=Ikt Galadion
イチゴヘビ=Strawberry Serpent
イノセントマジシャン=
イビルキャノン=Evil Cannon
イリヤのシャドウ=Kasumi's Shadow
イワアライグマ=Rockoon
イワノヅチ=Rock Hammer
インプ=Imp
ウーピーオーク=Whoopee Orc
ウイングロップ=Rabbicorn
ウェアウルフ=Werewolf
ウェアオルカ=Slaughter Whale
ウキキー=Monkey King
ウッドソウル=Wood Soul
ウパルパ=Sludge Salamander
エリコのシャドウ=Ruka's Shadow
エルダークラウド=Mine Lizard
エレクトロ・ギガス=Electro Goliath
エンゼルダーツ=
オーク=Squirrel Gunner
オクタスキッド=
カース・アルマ=Cursed Alma
カース・オラム=Tomo's Shadow
カオリのシャドウ=Kaori's Shadow
カクタスフラワー=Cactus Flower
カスミのシャドウ=Kasumi's Shadow
ガマボックリ=Pinetoad
カムツカイ=Ocean Herald
ギャングオッター=Mafiotter
キョウカのシャドウ=Kyoka's Shadow
キラービー=Killer Bee
クウカのシャドウ=Kuka's Shadow
グラスリザード=Treant
クリスタルゴーレム=Crystal Golem
クルミのシャドウ=Kurumi's Shadow
クレイジードギー=Crazy Pup
ゲートキーパー=Gatekeeper
ケイブエイプ=Cave Ape
ケイブスネイル=Cave Snail
ゴーレム=Golem
コドモオオトカゲ=Wyrmling
ゴブリンガード=Goblin Guard
ゴブリンメイスター=Goblin Meister
ゴブリンリトル=Goblin Squirt
コボルト=Yui's Shadow
コボルトアサシン=Kobold Assassin
コマンド・ウキキー=Monkey Commander
サラマンダー=Lava Lizard
サレンのシャドウ=Saren's Shadow
サンドガーゴイル=
サンドボア=Sand Boar
サンドワーム=
ジータのシャドウ=Djeeta's Shadow
シオリのシャドウ=Shiori's Shadow
シズルのシャドウ=Shizuru's Shadow
シノブのシャドウ=Shinobu's Shadow
シャークグリード=
ジャングルガード=Jungle Guard
ジュンのシャドウ=Jun's Shadow
スカルフレイム=Flaming Skulls
スズナのシャドウ=Suzuna's Shadow
スズメのシャドウ=Suzume's Shadow
スティンクスカンク=Stinkskunk
スノウゴート=Snow Ram
スパイククラブ=Spike Crab
スリーピィオウル=Sleepy Owl
ゼラチナ=Gellatina
ソウルイーター=
タツノコナイト=Seahorse Knight
タビガラス=Wandering Crow
タマキのシャドウ=Tamaki's Shadow
チカのシャドウ=Chika's Shadow
ツキツキ=Peckpecker
ツチノコブラ=Tsuchino Kobra
ツムギのシャドウ=Tsumugi's Shadow
トドドン=Sealidon
トモのシャドウ=Tomo's Shadow
ドリアード=Dryad
ドリルモール=Rock Lizard
トレント=Treant
トレントキャッスル=
ナッツシューター=Squirrel Gunner
ナナカのシャドウ=Nanaka's Shadow
ニノンのシャドウ=Ninon's Shadow
ニンフ=Nymph
ネジレアカシア=Twisted Acacia
ノーティビーバー=Heaver
ノイジーオーク=
ノゾミのシャドウ=Nozomi's Shadow
ハーミットナイト=Ice Fish
バーンウルフ=
ハイ・ガルグ=High Garoog
ハイオーク=High Orc
バジリスク=Basilisk
ハツネのシャドウ=Hatsune's Shadow
バットケイブ=Cave Bat
バルーンバード=Tanukid
ハンマーキャンサー=Hammer Crab
ビッグル=Biggle
ヒヨリのシャドウ=Hiyori's Shadow
ファイヤーメイジ=Fire Mage
プチグリフォン=Mini-Gryphon
プチデビル=Little Devil
ブルーゴーレム=Blue Golem
フレアゼラチナ=Rin's Shadow
ポイズントード=Poison Toad
ポイズンポッド=Poison Pod
ポイドン=Poidon
ホオズキムシ=Fire Lover
マインリザード=Mine Lizard
マグマウパルパ=Orc
マグマフィッシュ=Magma Salamander
マコトのシャドウ=Makoto's Shadow
マジックレイ=Magic Manta
マスター・ウキキー=Monkey Master
マダムエレクトラ=
マツリのシャドウ=Matsuri's Shadow
マッドクラウン=Mad Clown
マッドファントム=
マッドフラワー=Mad Flower
マヒルのシャドウ=Mahiru's Shadow
マホのシャドウ=Maho's Shadow
ミサキのシャドウ=Misaki's Shadow
ミサトのシャドウ=Misato's Shadow
ミストシーカー=
ミソギのシャドウ=Misogi's Shadow
ミツキのシャドウ=Wandering Crow
ミフユのシャドウ=Mifuyu's Shadow
ミミのシャドウ=Saren's Shadow
ミヤコのシャドウ=Miyako's Shadow
ムックル=Mookle
モグリクラゲ=Jellyfish Diver
モニカのシャドウ=Monika's Shadow
ユイのシャドウ=Yui's Shadow
ユカリのシャドウ=Yukari's Shadow
ユキのシャドウ=Yuki's Shadow
ヨリのシャドウ=Yori's Shadow
ラットン=Ratton
ラフレシアマンドラゴラ=
ランドスネーク=Land Snake
リーフボア=Leafy Boar
リトルアイ=Little Eye
リノのシャドウ=Rino's Shadow
リマのシャドウ=Lima's Shadow
リンのシャドウ=Rin's Shadow
ルインドール=Ruins Doll
ルカのシャドウ=Ruka's Shadow
ルナポッド=Lunapod
レイジングジョー=
レイのシャドウ=Rei's Shadow
ロード・イビリィ=Lord Evyle
ロックソウル=Yori's Shadow
ロックフラワー=Rock Flower
ロックリザード=Rock Lizard
ワイズワンド=Wisewand
ワイルドホーン=Wild Horn
ワイルドボア=Wild Boar
ワタリトビ=Wandering Kite
ワッパダヌキ=Tanukid
塔の雨神様=
壊乱の黒鎧騎士=Dark Knight of Corruption
水瑚麟=Coral Qilin
泥人形=Clay Doll
紅極鳥=Thunorfugol
魂喰らいの凶蛇=

